1111111111111
1001000000EC1
1000011101111
1P0011C000001
1111111111111